%%%%%%%%%%%%%
%.   %.#   .%
%    %%%    %
%#%       %%%
%.%   P   #.%
%%%       %%%
%    %%%    %
%.   #.%   .%
%%%%%%%%%%%%%
