%%%%%%%%%
%       %
%%%   %#%
%.# P #.%
%#%   %%%
%   .   %
%%%%%%%%%
