%%%%%%%%%%
%        %
%%%    %#%
%.#  P #.%
%#%    %%%
%    .   %
%%%%%%%%%%
