%%%%%%
%    %
%  %#%
%P #.%
%  %#%
%   .%
%%%%%%
