%%%%%%%
%    P%
%     %
%#%%%%%
%     %
%.    %
%%%%%%%
