%%%%%%
%    %
%  %#%
%P #.%
%  %#%
%    %
%%%%%%
